_X_X_X_X_X_X_X_X_X_X_X_X_X_X_X_X_X_X_X_X_X_X_X_X_X
_XXXXXXXX_XXXXXXXXXXXXXXXXXXXXXXXXXXXXXXXXXXXXXXX_
__________XXXXXXXXXXXXXXXXXXXXXXXXXXXXXXXXXXXXXXX_
_XXXXXXXXXXXXXXXXXXXXXXXXXXXXXXXXXXXXXXXXXXXXXXXX_
____________XXX________X______XXXX________________
XXXXXXXXXXX_____XXXXXX___XXXX______XXXXXXXXXXXXXXX
XXXXXXXXXXXXXXXXXXXXXXXXXXXXXXXXXXXXXXXXXXXXXXXXXX
________XXXXXXXX__________________________________
________XXXXXXXX_____XXXX_________________________
_____________________XXXX_________________________
________________________________XXXXXX____________
________________________________XXXXXX____________
________XX______________________XXXXXX____________
________XX______________XXXXXXXXXXXXXX____________
________________________XXXXXXXXXXXXXX____________
__________________________________________________
__________________________________________________
__________________________________________________
________XXX_______________________________________
________XXX_______________________________________
________XXX_______________________________________
__________________________________________________
________XXXXXXXX__________________________________
________XXXXXXXX_____XXXX_________________________
_____________________XXXX_________________________
________________________________XXXXXX____________
________________________________XXXXXX____________
________XX______________________XXXXXX____________
________XX______________XXXXXXXXXXXXXX____________
________________________XXXXXXXXXXXXXX____________
__________________________________________________
__________________________________________________
__________________________________________________
________XXX_______________________________________
________XXX_______________________________________
________XXX_______________________________________
__________________________________________________
________XXXXXXXX__________________________________
________XXXXXXXX_____XXXX_________________________
_____________________XXXX_________________________
________________________________XXXXXX____________
________________________________XXXXXX____________
________XX______________________XXXXXX____________
________XX______________XXXXXXXXXXXXXX____________
________________________XXXXXXXXXXXXXX____________
________________________________XXXXXX____________
________________________________XXXXXX____________
________XX______________________XXXXXX____________
________XX______________XXXXXXXXXXXXXX____________
________________________XXXXXXXXXXXXXX____________